Titre: 2key
WWWWWWWW
W......W
W..WWK.W
W.W..W.W
W.B.DT.W
WW.BT..W
W.B.DT.W
W.W..W.W
W..WWK.W
WS.....W
WWWWWWWW
