Map='facile'
WWWWWWWW
WWTTWTTW
WTB..B.W
WW.BBD.W
WTBD...W
WKW.WBBW
W.K.S.TW
WWWWWWWW
